ig.module( 'game.levels.' )
.requires( 'impact.image' )
.defines(function(){
LevelLevels.=/*JSON[*/{
	"entities": [],
	"layer": [
		{
			"name": "main",
			"width": 22,
			"height": 20,
			"linkWithCollision": false,
			"visible": true,
			"tilesetName": "media/maintiles.png",
			"repeat": false,
			"preRender": false,
			"distance": "1",
			"tilesize": 16,
			"foreground": false,
			"data": [
				[1,0,0,0,0,0,0,0,0,0,0,1,0,0,0,0,0,0,0,0,0,0],
				[1,0,0,0,0,0,0,0,0,0,0,1,0,0,0,0,0,0,0,0,0,0],
				[1,0,0,0,0,0,0,0,0,0,0,1,0,0,0,0,0,0,0,0,0,0],
				[1,0,0,0,0,0,0,0,0,0,0,1,0,0,0,0,0,0,0,0,0,0],
				[1,0,0,0,0,0,0,0,0,0,0,1,0,0,0,0,0,0,0,0,0,0],
				[1,0,0,0,0,0,0,0,0,0,0,1,0,0,3,0,11,12,0,4,0,0],
				[1,0,0,0,0,0,0,0,0,0,0,1,0,0,0,0,0,0,0,0,0,0],
				[1,0,0,0,0,0,0,0,0,0,0,1,0,0,6,8,8,8,8,5,0,0],
				[1,0,0,0,0,0,0,0,0,0,0,1,0,0,0,0,0,0,0,0,0,0],
				[1,0,0,0,0,0,0,0,0,0,0,1,0,0,0,0,0,0,0,0,0,0],
				[1,0,0,0,0,0,0,0,0,0,0,1,0,0,3,0,13,14,0,4,0,0],
				[1,0,0,0,0,0,0,0,0,0,0,1,0,0,0,0,0,0,0,0,0,0],
				[1,0,0,0,0,0,0,0,0,0,0,1,0,0,6,8,8,8,8,5,0,0],
				[1,0,0,0,0,0,0,0,0,0,0,1,0,0,0,0,0,0,0,0,0,0],
				[1,0,0,0,0,0,0,0,0,0,0,1,0,0,0,0,0,0,0,0,0,0],
				[1,0,0,0,0,0,0,0,0,0,0,1,0,0,3,0,15,16,0,4,0,0],
				[1,0,0,0,0,0,0,0,0,0,0,1,0,0,0,0,0,0,0,0,0,0],
				[1,0,0,0,0,0,0,0,0,0,0,1,0,0,6,8,8,8,8,5,0,0],
				[1,0,0,0,0,0,0,0,0,0,0,1,0,0,0,0,0,0,0,0,0,0],
				[1,1,1,1,1,1,1,1,1,1,1,1,0,0,0,0,0,0,0,0,0,0]
			]
		},
		{
			"name": "collision",
			"width": 22,
			"height": 20,
			"linkWithCollision": false,
			"visible": true,
			"tilesetName": "",
			"repeat": false,
			"preRender": false,
			"distance": 1,
			"tilesize": 16,
			"foreground": false,
			"data": [
				[1,0,0,0,0,0,0,0,0,0,0,1,0,0,0,0,0,0,0,0,0,0],
				[1,0,0,0,0,0,0,0,0,0,0,1,0,0,0,0,0,0,0,0,0,0],
				[1,0,0,0,0,0,0,0,0,0,0,1,0,0,0,0,0,0,0,0,0,0],
				[1,0,0,0,0,0,0,0,0,0,0,1,0,0,0,0,0,0,0,0,0,0],
				[1,0,0,0,0,0,0,0,0,0,0,1,0,0,0,0,0,0,0,0,0,0],
				[1,0,0,0,0,0,0,0,0,0,0,1,0,0,0,0,0,0,0,0,0,0],
				[1,0,0,0,0,0,0,0,0,0,0,1,0,0,0,0,0,0,0,0,0,0],
				[1,0,0,0,0,0,0,0,0,0,0,1,0,0,0,0,0,0,0,0,0,0],
				[1,0,0,0,0,0,0,0,0,0,0,1,0,0,0,0,0,0,0,0,0,0],
				[1,0,0,0,0,0,0,0,0,0,0,1,0,0,0,0,0,0,0,0,0,0],
				[1,0,0,0,0,0,0,0,0,0,0,1,0,0,0,0,0,0,0,0,0,0],
				[1,0,0,0,0,0,0,0,0,0,0,1,0,0,0,0,0,0,0,0,0,0],
				[1,0,0,0,0,0,0,0,0,0,0,1,0,0,0,0,0,0,0,0,0,0],
				[1,0,0,0,0,0,0,0,0,0,0,1,0,0,0,0,0,0,0,0,0,0],
				[1,0,0,0,0,0,0,0,0,0,0,1,0,0,0,0,0,0,0,0,0,0],
				[1,0,0,0,0,0,0,0,0,0,0,1,0,0,0,0,0,0,0,0,0,0],
				[1,0,0,0,0,0,0,0,0,0,0,1,0,0,0,0,0,0,0,0,0,0],
				[1,0,0,0,0,0,0,0,0,0,0,1,0,0,0,0,0,0,0,0,0,0],
				[1,0,0,0,0,0,0,0,0,0,0,1,0,0,0,0,0,0,0,0,0,0],
				[1,1,1,1,1,1,1,1,1,1,1,1,0,0,0,0,0,0,0,0,0,0]
			]
		}
	]
}/*]JSON*/;
LevelLevels.Resources=[new ig.Image('media/maintiles.png')];
});